1111111111111111111111111111111111111111
1P00000000000000000000000000000000000001
1010000000000100001000000010000111110001
1010000000001010000100000100000100000001
1010000000010001000010001000000111110001
1010000000001010000001010000000100000001
1011111110000100000000100000000111110001
1000000000000000000000000000000000C00001
10000000000000000000000000000000000000E1
1111111111111111111111111111111111111111
