111111111111111111
1P000C001000000001
100000001000C00001
1000C0001000000001
1000000010C00000E1
111111111111111111
