111111111
100E0C001
111111111
