11111111111
100E0000A01
1P0000C0001
11111111111
