111111
1P0101
100101
100E01
100101
1C0101
111111
